11111111111111111
10001000000000001
10001000000000001
10000000000000001
10000001100000001
100010000000P0001
1000100000C000001
10001000000E00001
11111111111111111