11111111111111111111111111111111111111
11111111111111111000111111111111111111
10001000000000001C10000000000000000011
1000101110C011111011111111000000000011
10111110100010000010000001111111110011
100000001101100111101C00C0000000011001
10110110010000111C101C11C10000000C1001
10000000000000000000000000000E0X0000P1
11111111111111111111111111111111111111