11111111111111111111111111111111111111
10000000000010001C01000000000000000001
1CCC1100010011111011001111000000000011
10110000100010000010010001111111110011
101101010010100111001C00X0000000011001
1010CC10010000111C011C11C10000000C1001
10111C0100100000000100X0000000000000P1
10001100100100111C101C11C10000000C1001
1110001001010000000X00XC0X0E0000111011
1C111110001100111C101C11C10000001C1001
10000000000100000000000000X0000X000101
11111111101110CCC00001110111CX11101101
1C000100001111111111011101110100000001
1C1XC1010000000000C1C111000001C1111111
11110C01111111111111C00C01011101100011
111111111C0000000000CCC00001C0000010C1
11111111111111111111111111111111111111