11111111111111111111111111111111111111
10001000000000001C10000000000000000011
1000101110C011111011111111000000000011
10111110100010000010000001111111110011
100000001101100111101C00X0000000011001
10110110010000111C101C11C10000000C1001
100000000000000000000000000000000000P1
10110110010000111C101C11C10000000C1001
100000000000000000000000000E0000111011
10110110010000111C101C11C10000001C1001
10000000000000000000000000X0000X000001
11111111111111111111111111111111111111
11111111111111111111111111111111111111
11111111111111111111111111111111111111
11111111111111111111111111111111111111
11111111111111111111111111111111111111