11111111111111111111
100000000000000000E1
1CCCCCC0111100000001
10000000111100000001
10000000011P00000001
10000000000000000001
11111111111111111111