11111111111111111111111111111111111111111111
10000000000000000000000000000000000000111111
10000000000000000000000000000000000000111111
10000000000000000000000000000000000000111111
10000000000000000000000000000000000000111111
10000000000000000000000000000000000000111111
10000000000000000000000000000000000000111111
10000000000000000000000000000000000000111111
10000000000000000000000000000000000000111111
10000000000000000000C00000000000000000111111
1000000000000000000000E000X00000000000111111
10000000000000000000000000000000000000111111
10000000000000000000000000000000000000111111
10000000000000000000000000000000000000111111
10000000000000000000000000000000000000111111
10000000000000000000000000000000000000111111
10000000000000000000000000000000000000111111
10000000000000000000000000000000000000111111
10000000000000000000000000000000000000111111
10000000000000000000000000000000000000111111
10000000000000000000000000000000000000111111
10000000000000000000000000000000000000111111
10000000000000000000P00000000000000000111111
11111111111111111111111111111111111111111111
11111111111111111111111111111111111111111111