11111111111111111111111111111111111111
10000000001000000C00010000000001100001
1CCC1100000000111011001011111101001001
10110000100010010010010010001101010011
101101010010100111001C00X0100000011001
1010CC10010000111C011C10C10000111C1001
10111C0100100000010001X0001001000000P1
10001100100100111C100000C10010010C1001
1110001001010100000X01XC0X0E0010111011
1C111110001100011C1101C1C10010001C1001
10000000000100000100110010X0000X000101
11111111101111CC1000X1100110CX11101101
1C000100001000111101000100110100000001
1C1XC0010010101000C1C101100001C1111111
10111111111010101011C00C01111101100011
100000000C000000XCX0CC000000C0000010C1
11111111111111111111111111111111111111