1111111111111111111111111111111111111111111
1000000000000000000000000000000000000011111
1000000000000000000000000000000000000011111
1000000000000000000000000000000000000011111
1000000000000000000000000000000000000011111
1000000000000000000000000000000000000011111
1000000000000000000000000000000000000011111
1000000000000000000000000000000000000011111
1000000000000000000000000000000000000011111
10000000000000000000C0000000000000000011111
1000000000000000000000E000X0000000000011111
1000000000000000000000000000000000000011111
1000000000000000000000000000000000000011111
1000000000000000000000000000000000000011111
1000000000000000000000000000000000000011111
1000000000000000000000000000000000000011111
1000000000000000000000000000000000000011111
1000000000000000000000000000000000000011111
1000000000000000000000000000000000000011111
1000000000000000000000000000000000000011111
10000000000000000000P0000000000000000011111
1111111111111111111111111111111111111111111