1111111111111111111111111111111111
100000000000000C000001100000000001
1110010010101000001001010111110001
1010010100100000101001010000010001
1P0E10000C00C000C00000010000010001
1000010010101000001001011110110001
1000010010101000001001010000000001
1000000010001000001001010000001001
1000000000001110000001111110001001
1000000000000001111110000011111001
1001001000000000000000000000000001
1111111111111111111111111111111111
