11111111
1CCC1CC1
100111C1
1X011001
10000001
1E00P101
11111111